6 10
|--------|
|.F.|..-.|
|..-|@.P.|
|.F....-.|
|........|
|--------|